+------------------+
|***************-**|
|**---****---**---*|
|**-***************|
|*|*---*|--**|--*|*|
|*|**|**|  |*|***|*|
|*|**|**|--**|***|*|
|****|**|  |*|***|*|
|****|**|--**|--***|
|-*****************|
|**----***---**---*|
|*****-************|
|*|-****|**|*|*****|
|*|**-**|**|*|***-*|
|*--***-|*-|*|--***|
|**|*|*||*||*|*|*|*|
|*-|*|*--*--*|*|*|*|
|******************|
|*---**---****-**--|
+------------------+
